
NO ./textures/cobblestone/bright.png
SO ./textures/cobblestone/dark.png
EA ./textures/cobblestone/mediumbright.png
WE ./textures/cobblestone/mediumdark.png

C 14,108,196
F 0,152,31

11111111111111111111111111111
1000000000110000000000001111111
11101100000111000000000000111111111
1N010000000000000000000011111111111111
111111111011000001110000000000001
100000000011000001110111110111111
11110111111111011100000010001
11110111111111011101010010001
11000000110101011100000010001
10000000000000001100000010001
10000000000000001101010010001
110000011101010111110111100111
11111111111111111111111111111
