NO ./textures/colors/cat1.png
SO ./textures/colors/cat2.png
EA ./textures/colors/cat3.png
WE ./textures/colors/cat4.png
C 0,255,255
F 105,105,105

   11111111111111111111111
1110000000000000001100000011
101110S00111000001 101000001
1100100000011111001100000001
  111111111    110000111111
                111111
