NO ./textures/greystone.png
SO ./textures/mossy.png
EA ./textures/wood.png
WE ./textures/obsidian.png
F 220,100,0
C 225,30,0

            1111
          111000111
        1110011100111
      1111111  1111111

  1111       111       1111
 11001       101       10011
110011    111101111    110011
10001     1000W0001    10001
110011    111101111    110011
 11001       101       10011
  1111       111       1111

      1111111   1111111
        1110011100111
          111000111
             111
