NO ./textures/greystone.png
SO ./textures/mossy.png
WE ./textures/eagle.png
EA ./textures/wood.png
F 255,255,250
C 255,255,255
        1111111111111111111111111
        1000000000110000000000001
        1011000001110000000000001
        1001000000000000000000001
111111111011000001110000000000001
100000000011000001110111110111111
11110111111111011100000010001
11110111111111011101010010001
11000000110101011100000010001
100000000000000011000H0010001
10000000000000001101010010001
11000001110101011111011110S0111
11110111111101011101111010001
11111111 1111111 111111111111
11111111 1111111 111111111111
